WWWWWWWWWWWWWWWWWWWWWWWWWWWWWWWWWWWWWWWWWWWWWWWWWWWWWWWWWWWWWWWWWWWWWWWWWWWWWWWWWWWWWWWWWWWWWWWWWWWWWWWWWWWWWWWWWWWWWWWWWWWWWWWWWWWWWWWWWWWWWWWWWWWWWWWWWWWWWWWWWWWWWWWWWWWWWWWWWWWWWWWWWWWWWWWWWWWWWWWWWWWWWWWWWWWWWWWWWWWWWWWWWWWWWWWWWWWWWWWWWWWWWWWWWWWWWWW
W.............................................................................................................................................................................................................................................................W
W.............................................................................................................................................................................................................................................................W
W.............................................................................................................................................................................................................................................................W
W.............................................................................................................................................................................................................................................................W
W.............................................................................................................................................................................................................................................................W
W......................W....W.................................................................................................................................................................................................................................W
W......................W....W.................................................................................................................................................................................................................................W
W.............................................................................................................................................................................................................................................................W
W.............................................................................................................................................................................................................................................................W
W.............................................................................................................................................................................................................................................................W
W.............................................................................................................................................................................................................................................................W
W.............................................................................................................................................................................................................................................................W
W.............................................................................................................................................................................................................................................................W
W.............................................................................................................................................................................................................................................................W
W.............................................................................................................................................................................................................................................................W
W.............................................................................................................................................................................................................................................................W
W.............................................................................................................................................................................................................................................................W
W.............................................................................................................................................................................................................................................................W
W.............................................................................................................................................................................................................................................................W
W.............................................................................................................................................................................................................................................................W
W.............................................................................................................................................................................................................................................................W
W.............................................................................................................................................................................................................................................................W
W.............................................................................................................................................................................................................................................................W
W.............................................................................................................................................................................................................................................................W
W.............................................................................................................................................................................................................................................................W
W.............................................................................................................................................................................................................................................................W
W.............................................................................................................................................................................................................................................................W
W.............................................................................................................................................................................................................................................................W
W.............................................................................................................................................................................................................................................................W
W.............................................................................................................................................................................................................................................................W
W.............................................................................................................................................................................................................................................................W
W.............................................................................................................................................................................................................................................................W
W.............................................................................................................................................................................................................................................................W
W.............................................................................................................................................................................................................................................................W
W.............................................................................................................................................................................................................................................................W
W.............................................................................................................................................................................................................................................................W
W.............................................................................................................................................................................................................................................................W
W.............................................................................................................................................................................................................................................................W
WWWWWWWWWWWWWWWWWWWWWWWWWWWWWWWWWWWWWWWWWWWWWWWWWWWWWWWWWWWWWWWWWWWWWWWWWWWWWWWWWWWWWWWWWWWWWWWWWWWWWWWWWWWWWWWWWWWWWWWWWWWWWWWWWWWWWWWWWWWWWWWWWWWWWWWWWWWWWWWWWWWWWWWWWWWWWWWWWWWWWWWWWWWWWWWWWWWWWWWWWWWWWWWWWWWWWWWWWWWWWWWWWWWWWWWWWWWWWWWWWWWWWWWWWWWWWWW
